TActor 怪物目标对象类
GetRaceType(): number; RaceType:number;                  / 物种

GetMapName(): string;  MapName:string;                   / 所在地图ID

GetMap(): TEnvirnoment; Map:TEnvirnoment;                / 所在地图对象

GetName(): string;     Name:string;                      / 获取名称

SetName(Value: string): void;                            / 设置名称

GetMapY(): number;    MapY:number;                       / 获取Y坐标

GetMapX(): number;    MapX:number;                       / 获取X坐标

GetGender(): number;  Gender:number;                     / 获取性别

SetGender(Value: number): void;                          / 设置性别

GetDirection(): number; Direction:number;                / 获取当前方向 0-7

SetDirection(Value: number): void;                       / 设置当前方向 0-7

GetHair(): number;   Hair:number;                        / 获取发型

SetHair(Value: number): void;                            / 设置发型

GetJob(): number;   Job:number;                          / 获取职业

SetJob(Value: number): void;                             / 设置职业

GetNation(): number;  Nation:number;                     / 获取国别

SetNation(Value: number): void;                          / 设置国别

GetCamp(): number;  Camp:number;                         / 获取阵营

SetCamp(Value: number): void;                            / 设置阵营

GetGold(): number;    Gold:number;                       / 获取当前金币数量

SetGold(Value: number): void;                            / 设置当前包裹金币数量

GetMaxGold(): number;  MaxGold:number;                   / 获取可携带的最大金币数量

GoldChanged(): void;                                     / 向客户端更新货币信息显示

GetPkPoint(): number;   PkPoint:number;                  / 获取PK值

SetPkPoint(Value: number): void;                         / 设置PK值

GetPkLevel(): number;  PkLevel:number;                   / 获取PK等级

GetGhost(): boolean;  Ghost:boolean;                     / 是否已清除尸体(是否无效)

GetDeath(): boolean;  Death:boolean;                     / 是否死亡

GetHasHorse(): boolean; HasHorse:boolean;                / 是否拥有马牌

GetHorseType(): number;HorseType:number;                 / 获取马牌的类型

SetHorseType(Value: number): void;                       / 设置马牌的类型

GetOnHorse(): boolean; OnHorse:boolean;                  / 是否在骑马状态

SetOnHorse(Value: boolean): void;                        / 设置骑马状态

GetGuild(): TGuild;  Guild:TGuild;                       / 所在行会

GetCastle(): TUserCastle; Castle:TUserCastle;            / 所在城堡

GetHasGuild(): boolean; HasGuild:boolean;                / 是否拥有行会

GetGuildName(): string; GuildName:string;                / 获取当前所在行会名称

GetGuildRankName(): string; GuildRankName:string;        / 行会称呼

GetIsGuildMaster(): boolean; IsGuildMaster:boolean;      / 是否行会帮主

GetISCastleMaster(): boolean; ISCastleMaster:boolean;    / 是否城堡城主

GetISCastleGuild(): boolean; ISCastleGuild:boolean;      / 行会是否属于城堡拥有者

GetInSafeZone(): boolean; InSafeZone:boolean;            / 是否处于安全区

GetCheck(Index: number): boolean;                        / 获取Check变量

SetCheck(Index: number；Value: boolean): void;           / 设置Check变量

GetSlaveAllCount():number; SlaveCount:number;            / 获取宝宝数量

GetSlave(Index: number): TActor;                         / 取指定序号的宝宝对象

GetSlaveLevel(): number; SlaveLevel:number;              / 获取宝宝等级

SetSlaveLevel(Value: number): void;                      / 设置宝宝等级

GetItemCount(ItemName: string): number; ItemCount:number;  / 查找拥有指定名称的物品数量

GetPoseCreate(): TActor; PoseCreate:TActor;              / 获取站在对面的角色对象

GetHP(): number; HP:number;                              / 获取当前血量

SetHP(Value: number): void;                              / 设置当前血量

GetMaxHP(): number; MaxHP:number;                        / 获取血量上限

SetMaxHP(Value: number): void;                           / 设置血量上限

GetMP(): number;  MP:number;                             / 获取当前蓝量

SetMP(Value: number): void;                              / 设置当前蓝量

GetMaxMP(): number; MaxMP:number;                        / 获取蓝量上限

SetMaxMP(Value: number): number;                         / 设置蓝量上限

GetDCMin(): number; DCMin:number;                        / 获取攻击下限

SetDCMin(Value: number): void;                           / 设置攻击下限

GetDCMax(): number; DCMax:number;                        / 获取攻击上限

SetDCMax(Value: number): void;                           / 设置攻击上限

GetMCMin(): number; MCMin:number;                        / 获取魔法下限

SetMCMin(Value: number): void;                           / 设置魔法下限

GetMCMax(): number; MCMax:number;                        / 获取魔法上限

SetMCMax(Value: number): void;                           / 设置魔法上限

GetSCMin(): number; SCMin:number;                        / 获取道术下限

SetSCMin(Value: number): void;                           / 设置道术下限

GetSCMax(): number; SCMax:number;                        / 获取道术上限

SetSCMax(Value: number): void;                           / 设置道术上限

GetTCMin(): number; TCMin:number;                        / 获取射术下限

SetTCMin(Value: number): void;                           / 设置射术下限

GetTCMax(): number; TCMax:number;                        / 获取射术上限

SetTCMax(Value: number): void;                           / 设置射术上限

GetPCMin(): number; PCMin:number;                        / 获取刺术下限

SetPCMin(Value: number): void;                           / 设置刺术下限

GetPCMax(): number; PCMax:number;                        / 获取刺术上限

SetPCMax(Value: number): void;                           / 设置刺术上限

GetWCMin(): number; WCMin:number;                        / 获取武术下限

SetWCMin(Value: number): void;                           / 设置武术下限

GetWCMax(): number; WCMax:number;                        / 获取武术上限

SetWCMax(Value: number): void;                           / 设置武术上限

GetACMin(): number; ACMin:number;                        / 获取防御下限

SetACMin(Value: number): void;                           / 设置防御下限

GetACMax(): number; ACMax:number;                        / 获取防御上限

SetACMax(Value: number): void;                           / 设置防御上限

GetMACMin(): number; MACMin:number;                      / 获取魔防下限

SetMACMin(Value: number): void;                          / 设置魔防下限

GetMACMax(): number; MACMax:number;                      / 获取魔防上限

SetMACMax(Value: number): void;                          / 设置魔防上限

GetSpeedPoint(): number; SpeedPoint:number;              / 获取敏捷

SetSpeedPoint(Value: number): void;                      / 设置敏捷

GetHitPoint(): number; HitPoint:number;                  / 获取准确

SetHitPoint(Value: number): void;                        / 设置准确

GetWalkSpeed(): number; WalkSpeed:number;                / 获取移动速度

SetWalkSpeed(Value: number): void;                       / 设置移动速度

GetWalkStep(): number; WalkStep:number;                  / 获取移动脚步大小

SetWalkStep(Value: number): void;                        / 设置移动脚步大小

GetWalkWait(): number; WalkWait:number;                  / 获取移动间隔时间

SetWalkWait(Value: number): void;                        / 设置移动间隔时间

GetAttackSpeed(): number; AttackSpeed:number;            / 获取攻击速度

SetAttackSpeed(Value: number): void;                     / 设置攻击速度

GetLuck(): number; Luck:number;                          / 获取幸运值

GetLevel(): number; Level:number;                        / 获取等级

SetLevel(Value: number): void;                           / 设置等级

GetExpHitter(): TActor; ExpHitter:TActor;                / 获取死亡后获得经验的对象

SetExpHitter(Value: TActor): void;                       / 设置死亡后获得经验的对象

LastHitter(): TActor;                                    / 获取死亡时杀死当前目标的对象

SetLastHitter(Value: TActor): void;                      / 设置死亡时杀死当前目标的对象

GetTargetActor(): TActor; TargetActor:TActor;            / 获取当前选择攻击的对象

SetTargetActor(Value: TActor): void;                     / 设置当前攻击的目标对象

SetTargetActorEx(Value: TActor,Time:number): void;       / 设置怪物在持续时间内 锁定攻击目标。如果攻击目标超出范围 (20坐标) ，或死亡或离开地图 则会立即被清除。

GetMaxBagSize(): number; MaxBagSize:number;              / 获取包裹最大容量

SetMaxBagSize(Value: number): void;                      / 设置包裹最大容量

GetItemSize(): number; ItemSize:number;                  / 获取当前包裹道具个数（叠加物品只算1个）

GetBagItem(Index: number): TUserItem;                    / 取得包裹里指定位置(编号)的物品

GetArmItem(AItemWhere: number): TUserItem;               / 获取指定位置穿戴的物品

GetDress(): TUserItem; Dress:TUserItem;                  / 衣服

GetWepon(): TUserItem; Wepon:TUserItem;                  / 武器

GetWeapon(): TUserItem; Weapon:TUserItem;                / 武器

GetNeckLace(): TUserItem; NeckLace:TUserItem;            / 项链

GetZodiacs(index: number): TUserItem; Zodiacs:TUserItem;    / 生肖  （0-11）

GetJewelrys(index: number): TUserItem; Jewelrys:TUserItem;  / 首饰盒 （0-5）

GetHelmet(): TUserItem; Helmet:TUserItem;                / 头盔

GetRightHand(): TUserItem; RightHand:TUserItem;          / 蜡烛

GetArmringLeft(): TUserItem; ArmringLeft:TUserItem;      / 左手镯

GetArmringRight(): TUserItem; ArmringRight:TUserItem;    / 右手镯

GetRingLeft(): TUserItem; RingLeft:TUserItem;            / 左戒指

GetRingRight(): TUserItem; RingRight:TUserItem;          / 右戒指

GetBelt(): TUserItem; Belt:TUserItem;                    / 腰带

GetBoots(): TUserItem; Boots:TUserItem;                  / 鞋子

GetCharm(): TUserItem; Charm:TUserItem;                  / 宝石

GetMask(): TUserItem; Mask:TUserItem;                    / 面纱

GetBujuk(): TUserItem; Bujuk:TUserItem;                  / 毒符

GetFashion(): TUserItem; Fashion:TUserItem;              / 时装

GetMount(): TUserItem; Mount:TUserItem;                  / 马牌

GetShield(): TUserItem; Shield:TUserItem;                / 盾牌

GetExp(): number; Exp:number;                            / 获取当前经验值

SetExp(Exp: number): void;                               / 设置当前经验值

GetMaxExp(): number; MaxExp:number;                      / 获取当前经验值上限

AddExp(Value: number): void;                             / 增加经验值（小于0减少经验值）

GetWeight(): number; Weight:number;                      / 获取当前包裹负重

GetMaxWeight(): number; MaxWeight:number;                / 获取当前包裹负重上限

GetWearWeight(): number; WearWeight:number;              / 获取当前穿戴负重

GetMaxWearWeight(): number; MaxWearWeight:number;        / 获取当前穿戴负重上限

GetHandWeight(): number; HandWeight:number;              / 获取当前腕力

GetMaxHandWeight(): number; MaxHandWeight:number;        / 获取当前腕力上限

ClearSkill(): void;                                      / 删除全部已学技能

DelNoJobSkill(): void;                                   / 删除非本职业的所有技能

DelSkill(ASkillName: string): void;                      / 删除指定名称的技能



// 增加一个技能 （参数1：技能名称，参数2：技能等级）
AddSkill( ASkillName: string,SkillLevel?: number) =>  void;

// 查找指定名称的技能，查找失败返回null
FindSkill(ASkillName: string): TUserMagic;

// 修改指定技能的等级 （参数1：技能名称，参数2：技能等级）
ChangeSkillLevel(ASkillName: string；SkillLevel: number): void;

// 检测是否可以穿戴指定位置的装备 （参数1：穿戴的装备，参数2：穿戴的位置）
CheckCanTakeOnItem(AUserItem: TUserItem；ItemWhere: number): boolean;

// 检测是否可以脱下指定位置的装备 （参数1：穿戴的装备，参数2：脱下的位置）
CheckCanTakeOffItem(ItemWhere: number): boolean;

// 将指定的装备穿戴在身上某个部位
TakeOnItem(AUserItem: TUserItem；ItemWhere: number): void;

// 将身上指定部位的装备取下
TakeOffItem(nItemWhere: number): void;

// 增加一个物品到背包，如果背包满了返回为false
AddItemToBag(Item: TUserItem): boolean;

// 设置当前对象死亡
Die(): void;

// 死亡并且直接清除尸体
MakeGhost(): void;

// 当前对象是否为玩家
IsPlayer(): boolean;

// 判断当前对象是否可以攻击
IsAttackTarget(Target): boolean;

// 当前对象是否为Npc
IsNPC(): boolean;

// 当前对象是否为怪物Npc
IsMonNPC(): boolean;

// 判断当前对象是否为神秘人
GetIsUnknowActor(): boolean;

// 设置当前对象是否为神秘人
SetIsUnknowActor(Value: boolean): void;

// 判断当前对象是否管理模式
GetIsAdminMode(): boolean; IsAdminMode:boolean;

// 设置当前对象是否管理模式
SetIsAdminMode(Value: boolean): void;

// 判断当前对象是否无敌模式
GetSuperManMode(): boolean; SuperManMode:boolean;

// 设置当前对象是否无敌模式
SetSuperManMode(Value: boolean): void;

// 判断当前对象是否隐身模式
GetObserverMode(): boolean; ObserverMode:boolean;

// 判断当前对象是否隐身模式
SetObserverMode(Value: boolean): void;

// 获取权限等级
GetPermission(): number; Permission:number;

// 设置权限等级
SetPermission(Value: number): void;

// 获取攻击模式
GetAttackMode(): number; AttackMode:number;

// 设置攻击模式
SetAttackMode(Value: number): void;

// 删除指定位置的物品
DeleteUseItem(NWhere: number): void;

// 修复指定位置的物品
RepairItem(NWhere: number): void;

// 修复全身物品
RepairAll(): void;

// 获取当前对象的名字颜色
GetNameColor(): number; NameColor:number;

// 设置当前对象的名字颜色
SetNameColor(Value: number): void;

// 杀死指定名称的召唤怪，如果数量为0则杀死相同名字的全部召唤怪
KillSlave( ASlaveName: string,ACount?: number) =>  void;

// 查找距离身边指定范围的召唤怪数量，如果名称为空则返回全部
GetSideSlaveCount(Range: number；ASlaveName: string): number; SideSlaveCount:number;

// 查找召唤怪数量，名称为空时返回全部数量
GetSlaveCount(ASlaveName: string): number;

// 获取杀怪经验倍率
GetKillMonExpRate(): number; KillMonExpRate:number;

// 设置杀怪经验倍率
SetKillMonExpRate(Value: number): void;

// 设置限时的经验倍率 (参数1：倍率 10为0.1倍，参数2：限时时间 单位：秒)
// 例如：Player.ChangeKillMonExpRate(110,600) 倍率为1.1倍 时间为10分钟
// 对地图经验倍率、极品属性加成经验倍率、套装属性加成经验倍率、经验卷轴及脚本额外属性调整等无影响,加成效果同时存在
ChangeKillMonExpRate(ARate: number,ATime: number): void;

// 获取攻击倍率
GetPowerRate(): number; PowerRate:number;

// 动态修改攻击倍率 (参数1：倍率 10为0.1倍，参数2：限时时间 单位：秒)
ChangePowerRate(ARate: number；ATime: number): void;

// 判断对象是否为管理员
GetIsAdmin(): boolean; IsAdmin:boolean;

// 判断是否拥有管理权限（权限>6）
GetISSysOp(): boolean; ISSysOp:boolean;

// 杀死面前的怪物
Kill( AMode?: number) =>  void;

// 判断是否处于心灵启示状态
GetAlwaysShowHP(): boolean; AlwaysShowHP:boolean;

// 设置玩家或者怪物 总是处于心灵启示状态 (掉血始终广播给周围玩家)
SetAlwaysShowHP(Value: boolean): void;

// 重新计算能力值（比如血量、攻击、魔法、经验倍率等）
RecalcAbilitys(): void;

// 获取目标主人对象
GetMaster(): TActor; Master:TActor;

// 设置目标主人对象
SetMaster(Master: TActor): void;

// 获取怪物叛变时间
GetMasterRoyaltyTick(): number; MasterRoyaltyTick:number;

// 设置怪物叛变时间
SetMasterRoyaltyTick(Value: number): void;

// 判断目标是否为保护状态
GetProtect(): boolean; Protect:boolean;

// 设置目标是否为保护状态
SetProtect(Value: boolean): void;

// 获取战斗力
GetTotalAbility(): number; TotalAbility:number;

// 获取爆率文件名称
GetDropName(): string; DropName:string;

// 设置爆率文件名称
SetDropName(Value: string): void;

// 判断是否爆出背包物品
GetNoDropItem(): boolean; NoDropItem:boolean;

// 设置不爆出背包物品,设置为False则允许爆出
SetNoDropItem(Value: boolean): void;

// 判断是否爆出身上物品
GetNoDropUseItem(): boolean; NoDropUseItem:boolean;

// 设置不爆出身上物品,设置为False则允许爆出
SetNoDropUseItem(Value: boolean): void;

// 搜索可视范围（怪物只有搜索到了可视范围的可攻击角色才会攻击）
SearchViewRange(): void;

// 清除搜索范围列表（清除了搜索列表，怪物就不会再攻击了）
ClearViewRange(): void;

// 对目标施放魔法(目标对象，目标x坐标，目标y坐标，技能ID，是否执行施法动作)
MagicAttackXY( ATarget: TActor；ATargetX: number；ATargetY: number；AMagic: number；ClientPlayerHaveSpellAction?: boolean) =>  void;

// 对目标施放魔法(目标对象，目标x坐标，目标y坐标，技能对象，是否执行施法动作)
MagicAttackXYEx( ATarget: TActor；ATargetX: number；ATargetY: number；AMagic: TUserMagic；ClientPlayerHaveSpellAction?: boolean) =>  void;

// 对目标施放魔法(目标对象，技能ID，是否执行施法动作)
MagicAttack( ATarget: TActor；AMagic: number；ClientPlayerHaveSpellAction?: boolean) =>   void;

// 对目标施放魔法(目标对象，技能对象，是否执行施法动作)
MagicAttackEx( ATarget: TActor；AMagic: TUserMagic；ClientPlayerHaveSpellAction?: boolean) =>  void;

// 对目标施放魔法(目标对象，目标x坐标，目标y坐标，技能ID，技能等级，技能分组ID，是否执行施法动作)
MagicAttackGroup( ATarget: TActor；ATargetX: number；ATargetY: number；AMagic: number；Level: number；Group: number；ClientPlayerHaveSpellAction?: boolean) =>   void;

// 对目标造成伤害 （参数1：目标对象，参数2：伤害数值，参数3：技能ID，参数4：技能等级，参数5：是否飘血 默认的是true）
Damage(ATarget: TActor；AValue: number；MagicID?: number,MagicLevel?: number,ShowBleedNumber?: boolean): void;

// 对目标造成延时伤害 （参数1：目标对象，参数2：伤害数值，参数3：延迟时间 单位毫秒，参数4：技能ID，参数5：技能等级，参数6：是否飘血 默认的是true）
DamageDelay(ATarget: TActor；AValue: number；Delay: number; MagicID?: number,MagicLevel?: number,ShowBleedNumber?: boolean): void;

// 创建一个藏匿于地图上的攻击事件(X坐标,Y坐标,持续存在时间(毫秒),伤害间隔时间,单次伤害值,技能编辑器特效ID[可选参数])
CreateAttackEvent(AMapX: number；AMapY: number；ATime: number；AInterval: number；ADamage: number，SkillEffectID?: number): boolean;
// 其功能与TActor.CreateAttackEvent一致。区别在于带2的特效ID是 UI设计中的特效ID
CreateAttackEvent2(AMapX: number,AMapY: number,ATime: number,AInterval: number,ADamage: number,UIEffectID: number): boolean;

// 当前位置自动移动到指定的位置 （x坐标，y坐标，坐标范围）
MoveTo( DestX: number；DestY: number；ARange?: number) =>  boolean;

// 状态如下：
// 0: 绿毒 1: 红毒 2: 禁止释放魔法 3: 不能跑动，可以走动(蛛网，仅对人物生效)
// 4: 不能移动(仅对人物生效) 5: 麻痹 6: 陷阱(不能移动，对所有目标生效) 7: 护体神盾 
// 8: 隐身 9: 神圣战甲术 10: 幽灵盾 11: 魔法盾
// 获取目标当前状态
CheckState(AState: number): boolean;
// 设置目标当前状态(AState:状态 ATime：时间，单位：秒 AValue：伤害值)
SetState(AState: number；ATime: number；AValue: number): void;

// 用于将怪物或者玩家在一定时间内锁定在指定坐标矩形范围内，不可移动出去
// 参数1:左坐标，参数2：上坐标，参数3：右坐标，参数4：下坐标，参数5：持续时间 单位毫秒
BlockInArea(Left: number；Top: number；Right: number；Bottom: number；Duration: number): void;

// 解除 BlockInArea 限制
BreakBlockArea(): void;

// 推开目标（参数1：方向，参数2：推开的格数）
Push(ADirection: number；AStep: number): number;

// 增加日志(事件，物品名称，数量，日志描述)
AddGameLog1(Event: string；ItemName: string；Amount: number；Log: string): void;

// 增加日志(事件，日志描述)
AddGameLog2(Event: string；Log: string): void;

// 获取已学技能数量
GetSkillCount(): number; SkillCount:number;

// 获取指定编号技能对象
GetSkills(Index: number): TUserMagic;

// 移动到指定地图ID的坐标(参数1：地图ID，参数2：X坐标，参数3：Y坐标)
Move(sMapName: string；nX: number；nY: number): boolean;

// 游戏变身函数（参数1：要变身的怪物名字(数据库名字)，参数2：变身时间 单位：秒）
ChangeToMonster(sMonName: string；nSec: number): void;

// 立即取消变身
CancelToMonster(): void;

// 在名称中添加显示的称号
AddShowName(sName: string): void;

// 在名称中删除显示的称号
DelShowName(sName: string): void;

// 鼠标移动到玩家身上是否显示
HaveShowName(sName: string): boolean;

// 用于动态调整怪物掉落物品几率的倍率
SetDropItemRate(Value: number): void;

// 查询当前目标的爆率倍率
GetDropItemRate(): number; DropItemRate:number;

// 获取S变量的值
GetSVar(Index: number): string; SVar:string;

// 获取N变量的值
GetNVar(Index: number): number; NVar:number;

// 设置S变量的值
SetSVar(Index: number；S: string): void;

// 设置N变量的值
SetNVar(Index: number；Value: number): void;

// 设置身体绘制染色颜色
SetBlendColor(Value: number): void;

// 获取身体绘制染色颜色
GetBlendColor(): number; BlendColor:number;

// 设置武器绘制染色颜色
SetWeaponBlendColor(Value: number): void;

// 获取武器绘制染色颜色
GetWeaponBlendColor(): number; WeaponBlendColor:number;

// 发送消息 （参数1：消息内容，参数2：0：红色消息 1：绿色消息 2：蓝色消息 3：怪物模拟人物消息）
SendMessage( Msg: string,Kind?: number) =>  void;

// 获取下属(宝宝)的列表
GetSlaveList(): TActorList; SlaveList:TActorList;

// 获取下属(宝宝)的状态
GetSlaveRelax(): boolean; SlaveRelax:boolean;

// 设置下属(宝宝)的状态
SetSlaveRelax(Value: boolean): void;

// 设置是否可以穿怪
SetThroughMonster(Value: boolean): void;

// 判断当前是否可以穿怪
GetThroughMonster(): boolean; ThroughMonster:boolean;

// 设置是否可以穿人
SetThroughHuman(Value: boolean): void;

// 判断当前是否可以穿人
GetThroughHuman(): boolean; ThroughHuman:boolean;

// 设置当前是否可以穿过NPC
SetThroughNPC(Value: boolean): void;

// 判断当前是否可以穿NPC
GetThroughNPC(): boolean; ThroughNPC:boolean;

// 设置当前是否可以穿过卫士
SetThroughGuard(Value: boolean): void;

// 判断当前是否可以穿过卫士
GetThroughGuard(): boolean; ThroughGuard:boolean;

// 重置穿过怪物
ResetThroughMonster(): void;

// 重置穿过人物
ResetThroughHuman(): void;

// 重置穿过npc
ResetThroughNPC(): void;

// 重置穿过卫士
ResetThroughGuard(): void;

// 设置动态调节一次最多掉血量，同样适用于怪物 和 玩家。下线不保存
SetMaxDropHp(Value: number): void;

// 查询 动态调节一次最多掉血量
GetMaxDropHp(): number; MaxDropHp:number;

// 刷新角色外观，可用于动态更改武器 和衣服外观特效时候 刷新，不必在脱下来
RefFeature(): void;

// 刷新身上装备，用于修改了身上装备，通知到客户端
RefUseItem(): void;

// 查询当前对象自定义特效ID
GetCustomEffect(index: number): number;

// 设置自定义特效,可用于实现自定义动态称号功能。ID为UI设计中自定义特效ID（1-20）共20个
SetCustomEffect(index: number；Value: number): void;


// 货币类型 - MoneyType：
GAME_MONEY_TYPE_GOLD = 1;      // 金币
GAME_MONEY_TYPE_GAMEGOLD = 2;  // 元宝
GAME_MONEY_TYPE_GAMEPOINT = 3; // 游戏点
GAME_MONEY_TYPE_GAME_GIRD = 4; // 灵符
GAME_MONEY_TYPE_DIAMOND = 5;   // 金刚石

// 获取对应货币的数量
GetGameMoney(MoneyType: number): number; GameMoney:number;

// 设置货币的数量,Log 为日志描述
SetGameMoney(MoneyType: number；Value: number；Log: string): void;

// 是否可以给玩家增加货币 Value 为需要增加的货币数量
CanAddGameMoney(MoneyType: number；Value: number): boolean;

// 是否可以扣减玩家对应数量的货币 Value 为需要增加货币的数量
CanTakeGameMoney(MoneyType: number；Value: number): boolean;

// 给玩家增加 对应数量的货币 Log 为日志描述 成功则为返回True 失败返回False;
AddGameMoney(MoneyType: number；Value: number；Log: string): boolean;

// 扣除玩家对应数量的货币 成功返回True 失败返回False
TakeGameMoney(MoneyType: number；Value: number；Log: string): boolean;

// 获取目标头顶特效ID
GetTitleEffect(): number; TitleEffect:number;

// 设置头顶特效(版本管理器->UI设计->自定义特效->ID标识)  怪物也可以使用 需要调用UpdateName通知客户端
SetTitleEffect(Value: number): void;

// 判断对方是否友方单位
IsFriendlyTarget(Target: TActor): boolean;

// 判断对方是否友方单位
IsFrindlyTarget(Target: TActor): boolean;

// 查询对象是否自动回血
GetDenyAutoAddHP(): boolean; DenyAutoAddHP:boolean;

// 设置对怪物以及人物的自动回血 true 为不使用引擎的自动回血。
SetDenyAutoAddHP(Value: boolean): void;

// 只读属性 唯一标识 可以通过Handle是否相等来判断是否目标为同一对象
// npc 怪物 人物 玩家 卫士 宝宝 都有唯一的Handle标识
GetHandle(): number; Handle:number;

// 作用等同于Handle
GetHashCode(): number; HashCode:number;

//用于设置怪物往指定坐标点行走
//当到达指定坐标点时 将触发 GameLib.onActorReachedMissionXY(Actor:TActor,MissionX:number, MissionY:number, Range:number)
MissionToXY(X: number,Y: number, Range:number): boolean;

//调节视野范围 取值范围 0-99,不建议超过20. 否则将会导致严重的性能问题。
SetViewRange(Value: number): void;

//用于调整怪物的射程 仅对 数据库race = 181 怪物有效,其他无法修改。（有效范围1-99）
SetAttackRange(Value: number): void;
GetAttackRange(): number;

//用于控制怪物收到攻击后是否会延长下一次攻击间隔时间 默认是true(原始设定) 。
//当如果是玩家的宝宝 改为false 可以使得宝宝在被多个怪物攻击时 不会延长攻击时间。
GetConfuseBitTimeBeAttacked(): boolean;
SetConfuseBitTimeBeAttacked(ConfuseBitTimeBeAttacked: boolean): void;

//执行逻辑的间隔时间 默认200毫秒  间隔越小,怪物反应越及时  但是性能更差。
GetRunInterval(): number;
SetRunInterval(RunInterval: number): void;

//用于动态修改怪物和NPC 是否触发脚本函数 对应为  复活触发  死亡触发 杀怪触发 和 受到伤害触发。
//复活触发
GetTriggerRevivalEvent(): boolean;
SetTriggerRevivalEvent(Value: boolean): void;
//死亡触发
GetTriggerDieEvent(): boolean;
SetTriggerDieEvent(Value: boolean): void;
//杀怪触发
GetTriggerKillerEvent(): boolean;
SetTriggerKillerEvent(Value: boolean): void;
//受到伤害触发
GetTriggerDamageEvent(): boolean;
SetTriggerDamageEvent(Value: boolean): void;


//TActor.ShowEffectEx2 与 TActor.ShowEffectEx 的差异为  TActor.ShowEffectEx限制播放特效数量为 1 播放过程中再次执行 会清理掉之前的特效
//TActor.ShowEffectEx2 限制特效数量为20个
//EffectID:特效ID OffsetX：特效偏移x  OffsetY：特效偏移y OthersCanSee：其他人是否可见 LoopCount：重复播放次数 ClearIfDead：死亡是否清除特效
ShowEffectEx: ( EffectID: number,OffsetX?: number,OffsetY?: number,OthersCanSee?: boolean,LoopCount?: number,ClearIfDead?: boolean) =>  void;
ShowEffectEx2: ( EffectID: number,OffsetX?: number,OffsetY?: number,OthersCanSee?: boolean,LoopCount?: number,ClearIfDead?: boolean) =>  void;

//闪现移动到坐标
FlashMove(X: number,Y: number,IgnorActor: boolean): boolean;
//向某方向闪现最大距离，如果最大距离目标坐标不可行走或者有怪物，将依次减少冲刺距离尝试
FlashPush(Direction: number,MaxStep: number,IgnorActor: boolean): boolean;

//主动让宝宝叛变
Mutiny(): void;

//根据每个怪物独立的标志设定是否触发回调。
//在版本管理器内的刷怪配置状态触发 增加刷怪选项 是否执行这两个触发回调。
Actor.TriggerAINpcExecute = true
Actor.TriggerSelectMagicBeforeAttack = true
表示此角色将会触发执行 GameLib.onAINpcExecute 和 GameLib.onMonSelectMagicBeforeAttack

//用于脚本中动释放一个飞行动画
//Target为 飞行到的目标生物
//SkillEffectID 为技能编辑 器中的特效ID
//Speed 为飞行速度 通常为1.3 可以自行修改。此参数表示 客户端每毫秒行进的像素数量。
//FlyOverEffect 为可选参数 表示飞行到目标后 播放的动画ID 。此特效ID 是技能编辑器中设置的特效。
FlyEffect:( Target: TActor,SkillEffectID: number,Speed: number,FlyOverEffect?: number) =>  void;

//用以播放技能编辑器中的特效 Dir = -1 表示按照角色当前朝向播放。
PlayDir8Effect: ( SkillEffectID: number,Dir?: number) =>  void;

// 用于无目标播放飞行动画
// MapX:目标X, MapY:目标Y, SkillEffectID:特效ID, Speed:飞行速度(数值越小越慢), FlyOverEffect:飞行结束特效ID
FlyEffectNoTarget(MapX: number,MapY: number,SkillEffectID: number,Speed: number,FlyOverEffect: number): void;